################
---------------#
##############-#
#--------------#
#-##############
#--------------#
##############-#
#--------------#
#-##############
#--------------#
##############-#
#--------------#
#-##############
#--------------#
##############-#
##############-#